###############################
#                             #
#   /                         #
#                             #
#                            D#
#                       #######
#                             #
#                             #
#                             #
#                             #
#                             #
#                   !         #
###############################
          
          