####################
#    !  !  !  !   #
#  @@@@  @@@@  @@@@
#  @@@@   K   @@@@
#  @@@@  @@@@  @@@@
#     /    D      #
#  @@@@  @@@@  @@@@
#        X   G    #
####################
