#############      
#    F  !   @K     
# E @@@@  G @@@@@  
#   !  X    !   !  
# @@@@   D   @@@@  
#   /   @@@@  !  G 
#   @@@@   @@@@   #
#  X!      F     !#
#   G   #######  !#
####################
