###############################
#    !      G                 #
#  K                          #
#  D      G                   #
#  /   E                      #
#          X            #######
#  F               X          #
#            @                #
#                  !          #
#       F                     #
#                             #
#                   !         #
############################### 