#############      
#       !   @K     
#   @@@@  G @@@@@  
#   !  X    !      
# @@@@   D   @@@@  
#   /   @@@@  !    
#   @@@@   @@@@   #
#   !      F      #
#   G   #######   #
####################
