####################
#  !  @@@@   ! K #
# @@@@  G  @@@@  #
#       @@@@  !  #
# @@@  D   @@@@  #
#   /   @@@@  X  #
# @@@@  !   !   #
#   F        G   #
####################
