####################
#   K        G    #
#   ###  !  ###   #
#   # D    X  #   #
#   #     !   #   #
#   ###  /  ###   #
#       F         #
#   !       !     #
#  ####   ####    #
####################
