####################
# K    !  @@@@   #
# @@@@     G  !  #
#   X  @@@@   @@@#
#   !       D   #
#  @@@@  /   @@@ #
#   G   @@@@   ! #
#      !        #
####################
