###############################
#  / !                        #
#                             #
#                             #
#     D                       #
#                       #######
#                             #
#            @                #
#                             #
#                             #
#                   !         #
#                   !         #
##############################           