###    ###
 /G@ !#  #
###   #  #
#  G@@#@ F 
K!!  !@  #
#  @ @  !#
# E@  @  F
# ! #@X@ #
#  #    D#
X! #######
