########  !@@@ 
#   # G ! X@K@ 
# / # #   !@!@ 
#   @ F !  @@@ 
  @@@ #   !#E  
  ##    ####   
   G@  G#   G  
   @@ @@@@@@@  
   E    !@     
         @  G  
#F# @       @  
               
 # @@ @@@  @@##
X! !@ @X@  @G! 
! ! @ @E@  # D 
