D @    # G #@X 
 !@!    ### @E 
@@@ !    #  @G 
 !  #    #     
  !  F  #E#    
 #G    #XFX#   
     ######### 
      @X#F     
    !  @#      
@@@###! #  G   
 G   #   F  !  
    /#!   #  ! 
E    #  G ! @@@
    G@     !@!E
     @      @GK