###    ###
 /G@ !# K#
###   #  #
   G@@#@ F
 !!  !@  #
   @ @  !#
  E@  @  F
# ! #@X@ #
#  #    D#
X! #######
