###############################
#    !      G                 #
#  K                          #
#  D      G                   #
#  /                          #
#                       #######
#                             #
#            @                #
#                             #
#                             #
#                   !         #
#                   !         #
##############################           