####################
# K@   !  @@@@   #
##@@@@     G  !  #
#   X  @@@@   @@@#
# G !       D   #
#  @@@@  /   @@@ #
#   G   @@@@   ! #
#  E   ! F      #
####################
