################################
#                              #
#         @@@@@@@@@@@@         #
#       @@@@@@@@@@@@@@@@       #
#      @@@@@@      @@@@@@      #
#     @@@@@@        @@@@@@     #
#    @@@@@@          @@@@@@    #
#    @@@@@            @@@@@    #
#    @@@@              @@@@    #
#    @@@      !  !      @@@    #
#    @@                  @@    #
#    @@                  @@    #
#    @@         K        @@    #
#    @@                  @@    #
#    @@   @@@@      @@@@ @@    #
#    @@  @@@@@@    @@@@@@@@    #
#    @@  @@@@@@    @@@@@@@@    #
#    @@   @@@@      @@@@ @@    #
#    @@                  @@    #
#    @@      G   G       @@    #
#    @@  @            @  @@    #
#    @@  @@@@@@@@@@@@@  @@    #
#    @@@  @@@@@@@@@@@  @@@    #
#    @@@@  @@@@@@@@@  @@@@    #
#    @@@@@           @@@@@    #
#     @@@@@@       @@@@@@     #
#      @@@@@@@@@@@@@@@@       #
#       @@@@@@@@@@@@@@        #
#    /                         #
#    #################  D      #
################################
