 @  E#   @      
@@!     F@  # @G
 !@ #  ! @   #  
      !X!@   # E
 E # #####   #  
!#!  # D # !  G 
E! G#  E #  !   
EEE#X@ G  # #!  
### @@ /  #     
  !@   @ G#   F 
! F@  @ @# ##   
 !#  ######  @@@
  ####!@!   @   
G @@   !  ##    
  G@  F    @ #  
FE @    G  @ E  