###############################
#  / !                        #
#                             #
#                             #
#                            D#
#                       #######
#                             #
#                             #
#                             #
#                             #
#                   !         #
#                   !         #
############################## 
          
          