###############################
#  / !      G                 #
#  GK                         #
#                             #
#     D                       #
#                       #######
#                             #
#            @                #
#                             #
#                             #
#                   !         #
#                   !         #
##############################           